1111111111111111111111111111
1222222222222112222222222221
1211112111112112111112111121
1211112111112112111112111121
1211112111112112111112111121
1322222222222222222222222231
1211112112111111112112111121
1211112112111111112112111121
1222222112222112222112222221
1211112111110110111112111111
1222212111110110111112100000
1111212110000000000112100000
1222212110111111110112100000
1211112110000000000112111111
1222222000110110110002222221
1111112110113113110112111121
0000012110111111110112122221
0000012110000000000112121111
0000012110111111110112122221
1111112110111111110112111121
1222222222222112222222222221
1211112111112112111112111121
1211112111112112111112111121
1222112222222002222222112221
1112112112111111112112112111
1112112112111111112112112111
1322222112222112222112222231
1211111111112112111111111121
1211111111112112111111111121
1222222222222222222222222221
1111111111111111111111111111
